date,pure_peak_ability,peak_load,backup_power,backup_rate,industry_use,general_use,week_day,index
20170101,24957,22886,2071,9.05,268.503,196.229,0,0
20170102,26035,24483,1552,6.34,280.534,205.022,1,1
20170103,29152,28131,1021,3.63,320.449,234.193,2,2
20170104,29757,28485,1272,4.47,329.623,240.898,3,3
20170105,30065,28336,1729,6.1,330.137,241.273,4,4
20170106,29154,28002,1152,4.12,330.589,241.603,5,5
20170107,27814,25600,2214,8.65,306.516,224.01,6,6
20170108,25977,24133,1844,7.64,283.998,207.554,0,7
20170109,29377,27670,1707,6.17,315.17,230.335,1,8
20170110,29039,27787,1252,4.51,322.524,235.71,2,9
20170111,29590,27992,1598,5.71,325.791,238.098,3,10
20170112,29488,28186,1302,4.62,329.116,240.527,4,11
20170113,29140,27161,1979,7.29,325.652,237.996,5,12
20170114,26637,24726,1911,7.73,297.082,217.116,6,13
20170115,25518,24156,1362,5.64,281.042,205.394,0,14
20170116,28878,27370,1508,5.51,314.013,229.489,1,15
20170117,29076,27768,1308,4.71,325.097,237.59,2,16
20170118,29608,27768,1840,6.63,327.192,239.121,3,17
20170119,30109,27768,2341,8.43,327.982,239.698,4,18
20170120,29081,26889,2192,8.15,322.404,235.621,5,19
20170121,26836,24905,1931,7.75,299.903,219.178,6,20
20170122,25721,24230,1491,6.15,282.438,206.413,0,21
20170123,28830,26943,1887,7,313.076,228.804,1,22
20170124,28354,26779,1575,5.88,320.292,234.078,2,23
20170125,28220,25905,2315,8.94,310.395,226.846,3,24
20170126,25419,23012,2407,10.46,283.805,207.412,4,25
20170127,22511,20214,2297,11.36,243.423,177.9,5,26
20170128,22565,19672,2893,14.71,230.95,168.784,6,27
20170129,22378,19906,2472,12.42,233.093,170.35,0,28
20170130,22735,20118,2617,13.01,237.237,173.379,1,29
20170131,23924,21188,2736,12.91,244.939,179.009,2,30
20170201,25162,22191,2971,13.39,258.806,189.535,3,31
20170202,27057,24722,2335,9.45,289.089,211.714,4,32
20170203,27221,25592,1629,6.37,304.543,223.031,5,33
20170204,26421,24355,2066,8.49,293.56,214.988,6,34
20170205,26319,23414,2905,12.41,278.986,204.314,0,35
20170206,29010,26414,2596,9.83,310.075,227.082,1,36
20170207,28631,26899,1732,6.44,320.057,234.392,2,37
20170208,28810,27120,1690,6.23,324.007,237.285,3,38
20170209,28857,27088,1769,6.53,323.31,236.775,4,39
20170210,29366,27086,2280,8.42,324.35,237.536,5,40
20170211,27091,24557,2534,10.32,301.272,220.636,6,41
20170212,26825,23991,2834,11.81,285.43,209.034,0,42
20170213,28707,26862,1845,6.87,316.656,231.901,1,43
20170214,29167,27193,1974,7.26,325.037,238.04,2,44
20170215,29037,27232,1805,6.63,324.778,237.85,3,45
20170216,29690,27174,2516,9.26,324.481,237.633,4,46
20170217,29818,27241,2577,9.46,327.078,239.534,5,47
20170218,28383,26165,2218,8.48,319.23,233.787,6,48
20170219,25728,23850,1878,7.88,286.855,210.078,0,49
20170220,29813,27718,2095,7.56,322.494,236.177,1,50
20170221,29723,27762,1961,7.06,331.285,242.616,2,51
20170222,30014,28295,1719,6.07,336.296,246.285,3,52
20170223,29932,27527,2405,8.74,333.496,244.235,4,53
20170224,29464,27141,2323,8.56,328.736,240.748,5,54
20170225,26781,24638,2143,8.7,303.27,222.098,6,55
20170226,25640,23343,2297,9.84,282.442,206.845,0,56
20170227,25826,24078,1748,7.26,286.652,209.929,1,57
20170228,26593,25022,1571,6.28,297.169,217.631,2,58
20170301,29168,27261,1907,7,319.972,214.205,3,59
20170302,29327,27074,2253,8.32,322.782,216.086,4,60
20170303,28926,26914,2012,7.47,323.603,216.635,5,61
20170304,26511,24746,1765,7.13,301.165,201.614,6,62
20170305,26027,23990,2037,8.49,284.462,190.432,0,63
20170306,29410,27068,2342,8.65,317.131,212.303,1,64
20170307,29630,27568,2062,7.48,326.219,218.386,2,65
20170308,29971,27767,2204,7.94,328.478,219.899,3,66
20170309,29663,27844,1819,6.53,329.645,220.679,4,67
20170310,29640,27892,1748,6.27,332.956,222.896,5,68
20170311,26940,25149,1791,7.12,307.066,205.565,6,69
20170312,26224,24368,1856,7.62,289.286,193.661,0,70
20170313,29929,27892,2037,7.3,326.713,218.717,1,71
20170314,29854,27769,2085,7.51,329.612,220.658,2,72
20170315,29645,27774,1871,6.73,329.804,220.786,3,73
20170316,29971,28098,1873,6.67,332.764,222.768,4,74
20170317,29612,27896,1716,6.15,332.276,222.441,5,75
20170318,27428,25239,2189,8.68,308.612,206.6,6,76
20170319,26543,24394,2149,8.81,289.912,194.08,0,77
20170320,30339,28453,1886,6.63,328.554,219.949,1,78
20170321,30707,28197,2510,8.9,336.78,225.457,2,79
20170322,30379,28095,2284,8.13,334.616,224.008,3,80
20170323,30369,28035,2334,8.32,334.601,223.998,4,81
20170324,30280,27872,2408,8.64,334.257,223.768,5,82
20170325,26886,24624,2262,9.18,304.199,203.645,6,83
20170326,25817,23892,1925,8.06,282.75,189.286,0,84
20170327,29653,27222,2431,8.93,316.217,211.69,1,85
20170328,29900,27766,2134,7.69,328.486,219.904,2,86
20170329,30095,28022,2073,7.4,332.055,222.293,3,87
20170330,30320,27974,2346,8.39,333.617,223.339,4,88
20170331,30458,28040,2418,8.62,332.343,222.486,5,89
20170401,26766,24245,2521,10.4,293.726,203.895,6,90
20170402,25227,22905,2322,10.14,272.587,189.22,0,91
20170403,24997,22797,2200,9.65,271.462,188.44,1,92
20170404,25389,23637,1752,7.41,274.183,190.328,2,93
20170405,29559,27722,1837,6.63,318.184,220.873,3,94
20170406,30310,28161,2149,7.63,332.957,231.127,4,95
20170407,30425,28739,1686,5.87,339.621,235.754,5,96
20170408,28526,26288,2238,8.51,318.992,221.434,6,97
20170409,27252,25592,1660,6.49,302.878,210.247,0,98
20170410,31313,30236,1077,3.56,347.81,241.437,1,99
20170411,31504,29416,2088,7.1,349.896,242.885,2,100
20170412,30668,28004,2664,9.51,334.727,232.356,3,101
20170413,30214,28171,2043,7.25,331.139,229.866,4,102
20170414,30381,28259,2122,7.51,334.176,231.973,5,103
20170415,28108,26171,1937,7.4,315.019,218.676,6,104
20170416,27411,25504,1907,7.48,302.969,210.311,0,105
20170417,31815,30290,1525,5.03,349.128,242.353,1,106
20170418,32269,30723,1546,5.03,361.796,251.147,2,107
20170419,32052,31072,980,3.16,365.389,253.641,3,108
20170420,32325,30725,1600,5.21,363.071,252.032,4,109
20170421,32395,30988,1407,4.54,361.735,251.104,5,110
20170422,27440,24699,2741,11.1,308.309,214.018,6,111
20170423,26236,24088,2148,8.92,285.44,198.142,0,112
20170424,30489,28349,2140,7.55,327.021,227.007,1,113
20170425,31221,29158,2063,7.07,344.756,239.318,2,114
20170426,32091,30418,1673,5.5,355.286,246.627,3,115
20170427,30979,28348,2631,9.28,338.571,235.024,4,116
20170428,29816,27165,2651,9.76,326.675,226.766,5,117
20170429,27142,24747,2395,9.68,300.818,208.817,6,118
20170430,25999,24004,1995,8.31,285.355,198.084,0,119
20170501,28784,25611,3173,12.39,282.424,204.87,1,120
20170502,32201,29684,2517,8.48,324.007,235.035,2,121
20170503,33218,30931,2287,7.39,340.699,247.143,3,122
20170504,33315,31407,1908,6.08,347.71,252.229,4,123
20170505,33612,31854,1758,5.52,352.091,255.406,5,124
20170506,30210,27573,2637,9.56,321.32,233.085,6,125
20170507,28367,25867,2500,9.67,296.445,215.04,0,126
20170508,33237,31507,1730,5.49,342.186,248.221,1,127
20170509,33418,31569,1849,5.86,352.04,255.369,2,128
20170510,34005,32633,1372,4.21,357.768,259.524,3,129
20170511,34995,33011,1984,6.01,362.88,263.232,4,130
20170512,34143,32806,1337,4.08,362.449,262.92,5,131
20170513,30573,27824,2749,9.88,327.963,237.904,6,132
20170514,28630,26614,2016,7.58,305.024,221.264,0,133
20170515,33794,32336,1458,4.51,348.13,252.533,1,134
20170516,32322,30124,2198,7.3,336.77,244.292,2,135
20170517,33049,30141,2908,9.65,333.3,241.776,3,136
20170518,33916,31320,2596,8.29,344.17,249.661,4,137
20170519,33452,31080,2372,7.63,341.697,247.867,5,138
20170520,29433,26826,2607,9.72,310.523,225.253,6,139
20170521,28748,26159,2589,9.9,296.581,215.139,0,140
20170522,34514,32130,2384,7.42,344.213,249.692,1,141
20170523,34441,32720,1721,5.26,359.92,261.085,2,142
20170524,34663,33035,1628,4.93,361.979,262.579,3,143
20170525,33883,31042,2841,9.15,346.019,251.001,4,144
20170526,33036,30290,2746,9.06,336.698,244.24,5,145
20170527,29736,26347,3389,12.86,308.837,224.03,6,146
20170528,28293,25268,3025,11.97,289.916,210.304,0,147
20170529,29341,26189,3152,12.04,298.295,216.382,1,148
20170530,29301,26643,2658,9.98,301.063,218.391,2,149
20170531,35101,32677,2424,7.42,347.68,252.207,3,150
20170601,34820,31934,2886,9.04,342.911,261.243,4,151
20170602,33745,31745,2000,6.3,340.613,259.492,5,152
20170603,32889,30408,2481,8.16,324.862,247.493,6,153
20170604,29056,26587,2469,9.29,289.044,220.205,0,154
20170605,34266,31834,2432,7.64,331.911,252.863,1,155
20170606,34499,33099,1400,4.23,351.586,267.852,2,156
20170607,35388,34135,1253,3.67,362.462,276.138,3,157
20170608,35634,34011,1623,4.77,363.023,276.565,4,158
20170609,35549,33972,1577,4.64,362.558,276.211,5,159
20170610,33349,30970,2379,7.68,339.351,258.532,6,160
20170611,32387,29156,3231,11.08,321.73,245.106,0,161
20170612,35807,34589,1218,3.52,357.655,272.476,1,162
20170613,36072,34501,1571,4.55,362.393,276.085,2,163
20170614,34883,31925,2958,9.27,346.782,264.192,3,164
20170615,33810,30196,3614,11.97,328.619,250.356,4,165
20170616,33890,30978,2912,9.4,329.851,251.293,5,166
20170617,30273,27264,3009,11.04,303.739,231.4,6,167
20170618,29812,26316,3496,13.28,284.626,216.84,0,168
20170619,34232,30908,3324,10.76,324.46,247.186,1,169
20170620,35769,31901,3868,12.12,340.014,259.036,2,170
20170621,36246,33511,2735,8.16,352.91,268.861,3,171
20170622,36636,34515,2121,6.14,363.05,276.586,4,172
20170623,36330,34567,1763,5.1,365.688,278.596,5,173
20170624,34392,30919,3473,11.23,338.481,257.868,6,174
20170625,32030,29653,2377,8.02,321.827,245.181,0,175
20170626,37318,35139,2179,6.2,364.832,277.943,1,176
20170627,37083,35123,1960,5.58,373.349,284.432,2,177
20170628,37133,35300,1833,5.19,372.966,284.14,3,178
20170629,37035,35234,1801,5.11,369.354,281.389,4,179
20170630,36942,34894,2048,5.87,361.789,275.626,5,180
20170701,34444,30856,3588,11.63,321.836,270.554,6,181
20170702,32104,28576,3528,12.34,304.344,255.849,0,182
20170703,36847,35002,1845,5.27,344.231,289.381,1,183
20170704,36695,34889,1806,5.18,350.531,294.678,2,184
20170705,36913,34916,1997,5.72,351.088,295.145,3,185
20170706,37131,35280,1851,5.25,356.921,300.049,4,186
20170707,36639,34736,1903,5.48,346.993,291.703,5,187
20170708,33690,30418,3272,10.76,318.201,267.499,6,188
20170709,32093,29124,2969,10.19,304.52,255.997,0,189
20170710,36658,35022,1636,4.67,350.604,294.738,1,190
20170711,37210,35482,1728,4.87,359.055,301.843,2,191
20170712,36734,35444,1290,3.64,360.801,303.311,3,192
20170713,37383,35749,1634,4.57,362.923,305.095,4,193
20170714,37514,35548,1966,5.53,361.52,303.916,5,194
20170715,34690,31152,3538,11.36,332.587,279.593,6,195
20170716,32187,29259,2928,10.01,313.048,263.166,0,196
20170717,36587,34337,2250,6.55,349.659,293.945,1,197
20170718,37302,36107,1195,3.31,365.553,307.306,2,198
20170719,37709,36046,1663,4.61,364.931,306.782,3,199
20170720,37470,35973,1497,4.16,366.825,308.375,4,200
20170721,37555,36146,1409,3.9,367.363,308.828,5,201
20170722,35011,31441,3570,11.35,338.096,284.223,6,202
20170723,32374,30894,1480,4.79,323.781,272.189,0,203
20170724,37065,36148,917,2.54,364.487,306.409,1,204
20170725,37637,36213,1424,3.93,367.989,309.354,2,205
20170726,37785,36199,1586,4.38,365.698,307.428,3,206
20170727,37471,35626,1845,5.18,363.576,305.644,4,207
20170728,37171,35658,1513,4.24,366.728,308.294,5,208
20170729,33693,30003,3690,12.3,321.456,270.235,6,209
20170730,31542,27986,3556,12.71,288.817,242.797,0,210
20170731,34812,30600,4212,13.76,318.507,267.756,1,211
20170801,35343,33080,2263,6.84,335.206,291.821,2,212
20170802,36096,33476,2620,7.83,340.23,296.195,3,213
20170803,36478,34556,1922,5.56,349.136,303.948,4,214
20170804,36155,34717,1438,4.14,351.431,305.946,5,215
20170805,33615,31575,2040,6.46,330.022,287.308,6,216
20170806,32629,30675,1954,6.37,317.947,276.796,0,217
20170807,37011,36165,846,2.34,362.283,315.392,1,218
20170808,36890,36266,624,1.72,369.536,321.708,2,219
20170809,37104,36123,981,2.72,369.142,321.364,3,220
20170810,36957,35788,1169,3.27,368.745,321.019,4,221
20170811,37060,36417,643,1.77,368.828,321.09,5,222
20170812,34707,32480,2227,6.86,342.896,298.516,6,223
20170813,33624,30951,2673,8.64,324.604,282.591,0,224
20170814,37877,36052,1825,5.06,360.697,314.012,1,225
20170815,37610,36453,1157,3.17,360.867,314.161,2,226
20170816,38012,36390,1622,4.46,366.793,319.32,3,227
20170817,37970,36391,1579,4.34,367.63,320.048,4,228
20170818,37815,36295,1520,4.19,368.178,320.525,5,229
20170819,34692,32211,2481,7.7,338.513,294.7,6,230
20170820,33363,30715,2648,8.62,321.716,280.077,0,231
20170821,37989,36119,1870,5.18,361.014,314.289,1,232
20170822,37520,35285,2235,6.33,359.463,312.937,2,233
20170823,37083,34588,2495,7.21,355.082,309.123,3,234
20170824,36959,35493,1466,4.13,355.287,309.303,4,235
20170825,37086,35129,1957,5.57,353.967,308.153,5,236
20170826,33661,31487,2174,6.9,330.987,288.147,6,237
20170827,31942,29227,2715,9.29,311.68,271.339,0,238
20170828,37421,35541,1880,5.29,347.855,302.833,1,239
20170829,37478,36070,1408,3.9,361.471,314.686,2,240
20170830,37429,35447,1982,5.59,360.162,313.546,3,241
20170831,37211,34739,2472,7.11,356.037,309.956,4,242
20170901,36747,33050,3697,11.19,351.932,334.196,5,243
20170902,32854,29350,3504,11.94,319.431,303.332,6,244
20170903,30641,28063,2578,9.19,299.6,284.501,0,245
20170904,35998,33987,2011,5.92,345.405,327.997,1,246
20170905,36130,34360,1770,5.15,359.311,341.202,2,247
20170906,36977,35786,1191,3.33,369.562,350.937,3,248
20170907,37214,35014,2200,6.28,368.528,349.956,4,249
20170908,37284,35020,2264,6.46,364.928,346.536,5,250
20170909,32676,30543,2133,6.98,334.578,317.716,6,251
20170910,31330,29552,1778,6.02,317.158,301.175,0,252
20170911,37204,34904,2300,6.59,355.593,337.672,1,253
20170912,37318,35533,1785,5.02,369.164,350.56,2,254
20170913,37055,33922,3133,9.24,358.802,340.719,3,255
20170914,36245,32944,3301,10.02,348.026,330.487,4,256
20170915,35703,33981,1722,5.07,352.989,335.199,5,257
20170916,32594,30645,1949,6.36,329.911,313.284,6,258
20170917,30844,28336,2508,8.85,306.887,291.421,0,259
20170918,36385,33398,2987,8.94,339.963,322.83,1,260
20170919,36161,34280,1881,5.49,354.89,337.004,2,261
20170920,36778,34866,1912,5.48,359.847,341.712,3,262
20170921,36515,35001,1514,4.33,365.693,347.264,4,263
20170922,36658,35374,1284,3.63,369.006,350.409,5,264
20170923,33455,32106,1349,4.2,346.591,329.123,6,265
20170924,32246,30716,1530,4.98,329.802,313.181,0,266
20170925,37067,35817,1250,3.49,368.19,349.634,1,267
20170926,37684,36263,1421,3.92,377.893,358.848,2,268
20170927,37733,36419,1314,3.61,379.148,360.041,3,269
20170928,37176,36049,1127,3.13,377.612,358.581,4,270
20170929,37259,35355,1904,5.39,368.09,349.54,5,271
20170930,36189,34625,1564,4.52,354.078,336.234,6,272
20171001,32037,30280,1757,5.8,350.098,321.367,0,273
20171002,37238,35737,1501,4.2,393.891,361.566,1,274
20171003,37600,35900,1700,4.73,397.797,365.152,2,275
20171004,31971,29072,2899,9.97,342.778,314.648,3,276
20171005,36727,34702,2025,5.84,375.332,344.531,4,277
20171006,36349,34982,1367,3.91,385.428,353.798,5,278
20171007,32023,29560,2463,8.33,348.461,319.864,6,279
20171008,30823,28115,2708,9.63,328.554,301.592,0,280
20171009,30439,28876,1563,5.41,335.906,308.34,1,281
20171010,31527,30226,1301,4.3,347.136,318.649,2,282
20171011,36482,35287,1195,3.39,386.68,354.948,3,283
20171012,36379,34009,2370,6.97,381.023,349.754,4,284
20171013,34356,32265,2091,6.48,364.231,334.341,5,285
20171014,30689,28783,1906,6.62,334.531,307.078,6,286
20171015,29880,27360,2520,9.21,312.378,286.742,0,287
20171016,34804,33062,1742,5.27,360.552,330.963,1,288
20171017,34542,32730,1812,5.54,364.246,334.354,2,289
20171018,34763,32246,2517,7.8,359.051,329.586,3,290
20171019,33609,31277,2332,7.46,353.246,324.257,4,291
20171020,32992,30889,2103,6.81,344.404,316.14,5,292
20171021,29251,25858,3393,13.12,303.734,278.808,6,293
20171022,27193,24237,2956,12.2,277.572,254.793,0,294
20171023,31411,28665,2746,9.58,314.139,288.36,1,295
20171024,32125,29159,2966,10.17,325.935,299.188,2,296
20171025,32300,29244,3056,10.45,327.614,300.729,3,297
20171026,32070,29286,2784,9.51,327.413,300.543,4,298
20171027,31101,28805,2296,7.97,323.869,297.29,5,299
20171028,27861,25555,2306,9.02,296.494,272.163,6,300
20171029,27817,24209,3608,14.91,275.541,252.929,0,301
20171030,30799,28206,2593,9.19,308.63,283.303,1,302
20171031,31166,28541,2625,9.2,317.362,291.317,2,303
20171101,31274,29266,2008,6.86,346.257,298.148,3,304
20171102,32208,30135,2073,6.88,355.227,305.872,4,305
20171103,32349,29257,3092,10.57,350.751,302.018,5,306
20171104,28104,25602,2502,9.77,315.945,272.048,6,307
20171105,26699,24623,2076,8.43,295.95,254.83,0,308
20171106,32275,29620,2655,8.96,341.356,293.928,1,309
20171107,32589,30666,1923,6.27,360.974,310.821,2,310
20171108,32505,29840,2665,8.93,357.485,307.816,3,311
20171109,32474,30266,2208,7.3,358.912,309.044,4,312
20171110,32500,30592,1908,6.24,362.763,312.361,5,313
20171111,28410,26422,1988,7.52,326.375,281.028,6,314
20171112,26785,25166,1619,6.43,301.848,259.91,0,315
20171113,32449,29653,2796,9.43,344.265,296.433,1,316
20171114,32558,29969,2589,8.64,357.181,307.555,2,317
20171115,32415,29784,2631,8.84,356.865,307.282,3,318
20171116,32912,30463,2449,8.04,361.807,311.538,4,319
20171117,32806,30555,2251,7.37,362.079,311.772,5,320
20171118,28683,26189,2494,9.52,325.714,280.46,6,321
20171119,26802,24644,2158,8.76,296.278,255.114,0,322
20171120,31083,28771,2312,8.04,335.672,289.033,1,323
20171121,30933,29432,1501,5.1,347.629,299.329,2,324
20171122,31461,28955,2506,8.66,347.125,298.896,3,325
20171123,31514,28469,3045,10.7,338.884,291.8,4,326
20171124,31344,28326,3018,10.66,335.972,289.293,5,327
20171125,28322,25668,2654,10.34,312.964,269.481,6,328
20171126,27557,24769,2788,11.25,296.755,255.524,0,329
20171127,31142,28917,2225,7.69,334.102,287.682,1,330
20171128,31207,29698,1509,5.08,349.99,301.363,2,331
20171129,31334,29530,1804,6.11,352.362,303.404,3,332
20171130,31783,29186,2597,8.9,348.657,300.215,4,333
20171201,31041,28525,2516,8.82,343.364,242.758,5,334
20171202,28665,25628,3037,11.85,315.931,223.363,6,335
20171203,27600,24512,3088,12.6,297.004,209.982,0,336
20171204,31058,28274,2784,9.85,331.657,234.481,1,337
20171205,30483,28243,2240,7.93,337.694,238.75,2,338
20171206,30509,28455,2054,7.22,339.32,239.899,3,339
20171207,30597,28625,1972,6.89,342.167,241.912,4,340
20171208,30548,27863,2685,9.64,338.619,239.403,5,341
20171209,27748,25500,2248,8.81,312.374,220.849,6,342
20171210,26390,24230,2160,8.91,292.604,206.871,0,343
20171211,30349,27706,2643,9.54,327.19,231.323,1,344
20171212,31076,28558,2518,8.82,340.697,240.872,2,345
20171213,31113,28433,2680,9.43,342.499,242.147,3,346
20171214,30682,28558,2124,7.44,341.965,241.77,4,347
20171215,30435,28405,2030,7.14,342.696,242.286,5,348
20171216,28044,25515,2529,9.91,316.616,223.848,6,349
20171217,26747,24444,2303,9.42,295.842,209.16,0,350
20171218,30695,28210,2485,8.81,332.083,234.783,1,351
20171219,30886,28665,2221,7.75,343.472,242.835,2,352
20171220,30709,28082,2627,9.35,341.1,241.157,3,353
20171221,30796,28219,2577,9.13,340.143,240.481,4,354
20171222,30376,27748,2628,9.47,338.526,239.338,5,355
20171223,27899,25193,2706,10.74,313.562,221.689,6,356
20171224,27219,24260,2959,12.2,294.312,208.079,0,357
20171225,30394,27939,2455,8.79,328.296,232.106,1,358
20171226,30723,28461,2262,7.95,339.37,239.934,2,359
20171227,30500,28022,2478,8.84,337.816,238.836,3,360
20171228,30583,28229,2354,8.34,337.879,238.881,4,361
20171229,30204,27369,2835,10.36,332.959,235.402,5,362
20171230,28107,24718,3389,13.71,304.18,215.056,6,363
20171231,25563,23319,2244,9.62,282.69,199.862,0,364
20180101,25708,23638,2070,8.76,279.707,189.179,1,365
20180102,29536,27816,1720,6.18,321.468,217.423,2,366
20180103,30132,28253,1879,6.65,334.264,226.077,3,367
20180104,30716,28757,1959,6.81,337.945,228.567,4,368
20180105,30401,28260,2141,7.58,337.418,228.211,5,369
20180106,27842,26062,1780,6.83,314.58,212.765,6,370
20180107,26516,25011,1505,6.02,297.867,201.46,0,371
20180108,30068,28801,1267,4.4,334.839,226.466,1,372
20180109,30767,28910,1857,6.42,342.04,231.337,2,373
20180110,30269,28410,1859,6.54,338.775,229.128,3,374
20180111,30360,28583,1777,6.22,340.962,230.608,4,375
20180112,29838,28093,1745,6.21,338.708,229.083,5,376
20180113,27702,25694,2008,7.82,313.729,212.189,6,377
20180114,26597,24705,1892,7.66,292.266,197.672,0,378
20180115,29976,28269,1707,6.04,328.531,222.2,1,379
20180116,29701,28285,1416,5.01,337.009,227.935,2,380
20180117,29996,28340,1656,5.84,338.646,229.041,3,381
20180118,30893,29076,1817,6.25,343.104,232.056,4,382
20180119,30341,28467,1874,6.58,342.217,231.456,5,383
20180120,27804,25883,1921,7.42,316.158,213.831,6,384
20180121,26617,24695,1922,7.78,296.066,200.242,0,385
20180122,30267,28264,2003,7.09,329.891,223.12,1,386
20180123,30520,28381,2139,7.54,337.478,228.252,2,387
20180124,29989,28228,1761,6.24,337.327,228.15,3,388
20180125,30137,28352,1785,6.3,339.045,229.312,4,389
20180126,29638,27537,2101,7.63,334.841,226.468,5,390
20180127,27239,25383,1856,7.31,310.65,210.107,6,391
20180128,26727,24535,2192,8.93,293.956,198.815,0,392
20180129,30220,28397,1823,6.42,329.379,222.773,1,393
20180130,30377,28606,1771,6.19,341.17,230.749,2,394
20180131,30805,28364,2441,8.61,339.434,229.575,3,395
20180201,30717,28521,2196,7.7,333.391,243.377,4,396
20180202,30181,28202,1979,7.02,334.54,244.216,5,397
20180203,27968,26353,1615,6.13,315.291,230.164,6,398
20180204,27855,26273,1582,6.02,301.554,220.136,0,399
20180205,30535,29059,1476,5.08,336.218,245.441,1,400
20180206,30425,28510,1915,6.72,340.349,248.457,2,401
20180207,30352,28889,1463,5.06,343.688,250.894,3,402
20180208,30108,28436,1672,5.88,340.674,248.694,4,403
20180209,30303,28302,2001,7.07,336.194,245.423,5,404
20180210,28719,26015,2704,10.39,315.4,230.243,6,405
20180211,27426,25349,2077,8.19,297.184,216.946,0,406
20180212,29795,27324,2471,9.04,319.19,233.011,1,407
20180213,28283,26300,1983,7.54,315.526,230.335,2,408
20180214,25864,23482,2382,10.14,287.615,209.96,3,409
20180215,23401,20979,2422,11.54,251.816,183.827,4,410
20180216,23221,20759,2462,11.86,240.98,175.917,5,411
20180217,22981,20282,2699,13.31,239.086,174.534,6,412
20180218,23094,20987,2107,10.04,242.944,177.35,0,413
20180219,23665,22071,1594,7.22,254.426,185.733,1,414
20180220,25134,23261,1873,8.05,266.617,194.631,2,415
20180221,28111,26510,1601,6.04,302.924,221.136,3,416
20180222,28560,27283,1277,4.68,318.767,232.701,4,417
20180223,29169,27093,2076,7.66,319.701,233.383,5,418
20180224,27642,25317,2325,9.18,302.296,220.677,6,419
20180225,26963,24690,2273,9.21,288.796,210.822,0,420
20180226,29606,27435,2171,7.91,316.122,230.771,1,421
20180227,29498,27818,1680,6.04,327.071,238.764,2,422
20180228,28077,26394,1683,6.38,312.455,228.094,3,423
20180301,30211,28372,1839,6.48,338.639,230.015,4,424
20180302,30169,28143,2026,7.2,343.1,233.045,5,425
20180303,27936,26052,1884,7.23,320.965,218.01,6,426
20180304,27163,25431,1732,6.81,306.056,207.884,0,427
20180305,30489,29460,1029,3.49,348.508,236.719,1,428
20180306,29729,27989,1740,6.22,343.751,233.487,2,429
20180307,29746,28469,1277,4.49,345.499,234.675,3,430
20180308,29829,27944,1885,6.75,342.521,232.652,4,431
20180309,29527,27617,1910,6.92,337.21,229.045,5,432
20180310,26680,24946,1734,6.95,310.026,210.581,6,433
20180311,25934,24245,1689,6.97,291.992,198.332,0,434
20180312,29698,27935,1763,6.31,329.212,223.612,1,435
20180313,30329,28418,1911,6.72,340.495,231.277,2,436
20180314,30517,28536,1981,6.94,344.488,233.989,3,437
20180315,30915,28941,1974,6.82,348.197,236.507,4,438
20180316,30617,28620,1997,6.98,347.496,236.031,5,439
20180317,27594,25794,1800,6.98,319.111,216.752,6,440
20180318,26377,24808,1569,6.33,300.646,204.21,0,441
20180319,30763,29102,1661,5.7,342.507,232.642,1,442
20180320,30811,28823,1988,6.9,350.863,238.318,2,443
20180321,29622,27699,1923,6.94,338.012,229.589,3,444
20180322,29913,27982,1931,6.9,336.485,228.552,4,445
20180323,29539,27642,1897,6.86,335.959,228.196,5,446
20180324,26882,25149,1733,6.89,310.783,211.094,6,447
20180325,26288,24573,1715,6.98,295.048,200.407,0,448
20180326,30181,28383,1798,6.34,334.585,227.262,1,449
20180327,30599,28602,1997,6.98,346.188,235.143,2,450
20180328,30747,28752,1995,6.94,348.552,236.749,3,451
20180329,30773,28983,1790,6.18,351.558,238.79,4,452
20180330,30797,28897,1900,6.57,349.536,237.417,5,453
20180331,29785,27845,1940,6.97,340.3,231.143,6,454
20180401,26805,25072,1733,6.91,301.272,210.597,0,455
20180402,30941,29047,1894,6.52,340.082,237.727,1,456
20180403,31154,29267,1887,6.45,348.138,243.358,2,457
20180404,27716,26121,1595,6.11,317.561,221.985,3,458
20180405,26725,24981,1744,6.98,300.701,210.198,4,459
20180406,26158,24450,1708,6.99,299.055,209.048,5,460
20180407,25609,23940,1669,6.97,288.839,201.906,6,461
20180408,25549,23895,1654,6.92,281.561,196.819,0,462
20180409,30202,28232,1970,6.98,325.424,227.48,1,463
20180410,30727,28728,1999,6.96,340.376,237.932,2,464
20180411,31919,30193,1726,5.72,353.67,247.226,3,465
20180412,32244,30645,1599,5.22,363.582,254.154,4,466
20180413,32838,31068,1770,5.7,367.581,256.949,5,467
20180414,29530,27721,1809,6.53,344.904,241.098,6,468
20180415,26249,24630,1619,6.57,305.745,213.724,0,469
20180416,30283,28365,1918,6.76,332.007,232.082,1,470
20180417,30377,28399,1978,6.97,339.878,237.584,2,471
20180418,30394,28521,1873,6.57,341.485,238.708,3,472
20180419,31398,29442,1956,6.65,350.038,244.686,4,473
20180420,31370,29380,1990,6.77,350.586,245.07,5,474
20180421,28822,26962,1860,6.9,328.608,229.706,6,475
20180422,27981,26356,1625,6.17,314.343,219.735,0,476
20180423,33016,31487,1529,4.86,364.944,255.107,1,477
20180424,32818,31110,1708,5.49,368.681,257.718,2,478
20180425,31619,29570,2049,6.93,353.394,247.033,3,479
20180426,32008,29944,2064,6.89,356.264,249.038,4,480
20180427,32443,30356,2087,6.87,358.771,250.791,5,481
20180428,28710,26835,1875,6.99,331.936,232.032,6,482
20180429,27862,26074,1788,6.85,314.553,219.882,0,483
20180430,32159,30086,2073,6.89,353.337,246.992,1,484
20180501,30453,28665,1788,6.24,317.89,223.629,2,485
20180502,33931,32351,1580,4.88,347.624,244.547,3,486
20180503,32791,30659,2132,6.95,337.957,237.746,4,487
20180504,32728,30638,2090,6.82,333.49,234.603,5,488
20180505,29339,27477,1862,6.78,312.52,219.852,6,489
20180506,29436,27517,1919,6.97,302.099,212.52,0,490
20180507,34568,32762,1806,5.51,351.128,247.012,1,491
20180508,33882,31729,2153,6.78,347.632,244.552,2,492
20180509,32204,30104,2100,6.98,332.656,234.016,3,493
20180510,32262,30174,2088,6.92,329.666,231.914,4,494
20180511,32825,30735,2090,6.8,335.188,235.798,5,495
20180512,29347,27439,1908,6.95,313.183,220.318,6,496
20180513,28978,27088,1890,6.98,299.166,210.457,0,497
20180514,34906,32914,1992,6.05,347.687,244.59,1,498
20180515,35241,33518,1723,5.14,362.92,255.306,2,499
20180516,35790,34235,1555,4.54,371.263,261.176,3,500
20180517,36456,34692,1764,5.09,377.995,265.911,4,501
20180518,36837,35061,1776,5.07,377.045,265.243,5,502
20180519,32699,30567,2132,6.97,347.535,244.484,6,503
20180520,31435,29607,1828,6.17,329.814,232.018,0,504
20180521,36100,34269,1831,5.34,367.522,258.544,1,505
20180522,36648,34776,1872,5.38,376.947,265.175,2,506
20180523,36398,34892,1506,4.32,373.15,262.504,3,507
20180524,36459,34099,2360,6.92,368.514,259.242,4,508
20180525,36982,35023,1959,5.6,374.971,263.784,5,509
20180526,32536,30416,2120,6.97,347.016,244.118,6,510
20180527,32107,30287,1820,6.01,333.156,234.368,0,511
20180528,37298,36007,1291,3.59,381.747,268.552,1,512
20180529,37378,36329,1049,2.89,391.738,275.58,2,513
20180530,38003,36771,1232,3.35,393.897,277.098,3,514
20180531,38144,36713,1431,3.9,394.704,277.667,4,515
20180601,35895,33549,2346,6.99,362.036,283.3,5,516
20180602,30991,29031,1960,6.75,323.435,253.094,6,517
20180603,30428,28480,1948,6.84,311.431,243.7,0,518
20180604,36878,34478,2400,6.96,359.97,281.682,1,519
20180605,37569,35302,2267,6.42,373.32,292.13,2,520
20180606,37988,35802,2186,6.11,377.702,295.558,3,521
20180607,38050,35702,2348,6.58,380.397,297.668,4,522
20180608,38280,36102,2178,6.03,380.466,297.721,5,523
20180609,33692,31775,1917,6.03,351.602,275.135,6,524
20180610,31637,29798,1839,6.17,329.054,257.491,0,525
20180611,35126,32557,2569,7.89,353.874,276.913,1,526
20180612,35695,33517,2178,6.5,357.799,279.984,2,527
20180613,36145,34034,2111,6.2,361.361,282.771,3,528
20180614,35928,33737,2191,6.49,361.363,282.772,4,529
20180615,33730,31614,2116,6.69,344.5,269.578,5,530
20180616,30530,28619,1911,6.67,316.803,247.903,6,531
20180617,29158,27261,1897,6.96,301.447,235.887,0,532
20180618,29891,27948,1943,6.95,304.701,238.433,1,533
20180619,34613,32063,2550,7.95,341.183,266.981,2,534
20180620,34490,32244,2246,6.97,348.936,273.048,3,535
20180621,35351,33176,2175,6.56,356.063,278.625,4,536
20180622,36070,33748,2322,6.88,358.879,280.829,5,537
20180623,32242,30175,2067,6.85,333.169,260.71,6,538
20180624,31104,29174,1930,6.62,317.328,248.314,0,539
20180625,37390,35108,2282,6.5,365.614,286.1,1,540
20180626,37704,35259,2445,6.93,374.644,293.165,2,541
20180627,37537,35122,2415,6.88,373.386,292.181,3,542
20180628,37792,35448,2344,6.61,375.443,293.791,4,543
20180629,37395,34966,2429,6.95,372.612,291.575,5,544
20180630,32528,30484,2044,6.71,340.317,266.303,6,545
20180701,31002,29016,1986,6.85,313.525,270.26,0,546
20180702,35536,33151,2385,7.19,346.424,298.618,1,547
20180703,36355,34138,2217,6.49,356.862,307.617,2,548
20180704,36038,33744,2294,6.8,357.222,307.926,3,549
20180705,35454,33157,2297,6.93,354.923,305.945,4,550
20180706,36567,34306,2261,6.59,357.425,308.102,5,551
20180707,32483,30399,2084,6.86,329.519,284.046,6,552
20180708,30851,28916,1935,6.69,308.761,266.152,0,553
20180709,37243,34951,2292,6.56,355.959,306.838,1,554
20180710,37012,34753,2259,6.5,354.522,305.599,2,555
20180711,33349,31203,2146,6.88,335.903,289.549,3,556
20180712,36617,34408,2209,6.42,360.405,310.671,4,557
20180713,37207,34990,2217,6.34,364.861,314.511,5,558
20180714,33571,31279,2292,7.33,337.599,291.011,6,559
20180715,32283,29296,2987,10.19,316.764,273.052,0,560
20180716,37947,35178,2769,7.87,361.094,311.264,1,561
20180717,38713,36200,2513,6.94,376.937,324.921,2,562
20180718,38820,36460,2360,6.47,378.892,326.606,3,563
20180719,39052,36705,2347,6.39,380.275,327.798,4,564
20180720,38082,35740,2342,6.55,372.819,321.372,5,565
20180721,34258,31327,2931,9.36,339.94,293.029,6,566
20180722,32005,29333,2672,9.11,318.585,274.621,0,567
20180723,37187,34239,2948,8.61,357.398,308.078,1,568
20180724,38268,35976,2292,6.37,370.231,319.14,2,569
20180725,38300,35901,2399,6.68,370.374,319.264,3,570
20180726,38102,35806,2296,6.41,374.861,323.132,4,571
20180727,38118,35675,2443,6.85,372.019,320.682,5,572
20180728,33880,31376,2504,7.98,342.027,294.828,6,573
20180729,32696,30623,2073,6.77,325.854,280.888,0,574
20180730,38704,36318,2386,6.57,372.879,321.423,1,575
20180731,39262,36906,2356,6.38,384.918,331.8,2,576
20180801,39656,37351,2305,6.17,392.87,342.769,3,577
20180802,38579,36122,2457,6.8,387.28,337.892,4,578
20180803,38545,36116,2429,6.73,378.829,330.519,5,579
20180804,34993,31905,3088,9.68,345.256,301.227,6,580
20180805,33216,29660,3556,11.99,325.95,284.384,0,581
20180806,38502,36089,2413,6.69,370.238,323.024,1,582
20180807,38606,36132,2474,6.85,380.412,331.901,2,583
20180808,38683,36191,2492,6.89,381.473,332.826,3,584
20180809,38344,35872,2472,6.89,380.033,331.569,4,585
20180810,38376,36020,2356,6.54,379.108,330.762,5,586
20180811,35048,31721,3327,10.49,348.954,304.454,6,587
20180812,32669,30095,2574,8.55,328.497,286.605,0,588
20180813,37137,34739,2398,6.9,366.276,319.568,1,589
20180814,37179,34827,2352,6.75,367.15,320.33,2,590
20180815,36428,33954,2474,7.29,362.538,316.306,3,591
20180816,36643,34368,2275,6.62,365.157,318.59,4,592
20180817,37448,35182,2266,6.44,368.792,321.762,5,593
20180818,33763,30087,3676,12.22,337.459,294.425,6,594
20180819,31689,28654,3035,10.59,314.262,274.186,0,595
20180820,36747,34375,2372,6.9,355.196,309.901,1,596
20180821,36897,34675,2222,6.41,366.844,320.063,2,597
20180822,37148,34783,2365,6.8,368.883,321.842,3,598
20180823,36905,34745,2160,6.22,363.41,317.067,4,599
20180824,34004,30158,3846,12.75,331.715,289.414,5,600
20180825,32454,29174,3280,11.24,318.785,278.132,6,601
20180826,31095,28097,2998,10.67,303.468,264.768,0,602
20180827,36171,32329,3842,11.88,339.164,295.912,1,603
20180828,35990,31922,4068,12.74,340.574,297.143,2,604
20180829,35636,32109,3527,10.98,341.267,297.747,3,605
20180830,36284,31886,4398,13.79,339.521,296.224,4,606
20180831,36340,32264,4076,12.63,340.098,296.727,5,607
20180901,33138,28928,4210,14.55,323.766,306.718,6,608
20180902,31238,28176,3062,10.87,311.172,294.787,0,609
20180903,36670,33843,2827,8.36,356.349,337.585,1,610
20180904,37448,35163,2285,6.5,375.154,355.4,2,611
20180905,37512,35238,2274,6.45,380.514,360.478,3,612
20180906,37273,34890,2383,6.83,377.006,357.154,4,613
20180907,36905,34524,2381,6.9,372.136,352.541,5,614
20180908,32633,29661,2972,10.02,334.112,316.519,6,615
20180909,30523,26810,3713,13.85,302.999,287.045,0,616
20180910,35212,31645,3567,11.27,335.9,318.212,1,617
20180911,36386,33276,3110,9.35,356.845,338.054,2,618
20180912,36431,34117,2314,6.78,366.046,346.771,3,619
20180913,36902,34521,2381,6.9,370.062,350.576,4,620
20180914,36939,34631,2308,6.66,371.851,352.271,5,621
20180915,32429,29281,3148,10.75,335.877,318.191,6,622
20180916,31957,28947,3010,10.4,318.079,301.331,0,623
20180917,37448,35098,2350,6.7,368.839,349.418,1,624
20180918,37731,35327,2404,6.8,381.095,361.028,2,625
20180919,37394,34991,2403,6.87,379.265,359.295,3,626
20180920,37276,35019,2257,6.44,378.609,358.672,4,627
20180921,37296,34892,2404,6.89,376.558,356.73,5,628
20180922,32841,30272,2569,8.49,342.703,324.657,6,629
20180923,30594,27876,2718,9.75,320.887,303.991,0,630
20180924,30592,27223,3369,12.38,309.14,292.862,1,631
20180925,36686,32749,3937,12.02,347.48,329.183,2,632
20180926,35834,31949,3885,12.16,348.654,330.295,3,633
20180927,36176,31946,4230,13.24,347.09,328.814,4,634
20180928,35567,31510,4057,12.88,341.958,323.951,5,635
20180929,30986,26812,4174,15.57,303.753,287.759,6,636
20180930,29571,25505,4066,15.94,283.926,268.976,0,637
20181001,33805,30707,3098,10.09,351.846,290.97,1,638
20181002,34108,30992,3116,10.05,359.01,296.896,2,639
20181003,33579,30579,3000,9.81,356.281,294.639,3,640
20181004,33134,29852,3282,10.99,351.454,290.646,4,641
20181005,32771,30375,2396,7.89,353.136,292.038,5,642
20181006,29802,27097,2705,9.98,329.47,272.466,6,643
20181007,28580,25871,2709,10.47,310.399,256.694,0,644
20181008,33848,30873,2975,9.64,354.458,293.13,1,645
20181009,34236,31288,2948,9.42,365.03,301.873,2,646
20181010,30005,27562,2443,8.86,333.921,276.148,3,647
20181011,33013,29875,3138,10.5,350.095,289.523,4,648
20181012,32928,29172,3756,12.88,344.462,284.865,5,649
20181013,29462,26162,3300,12.62,315.851,261.204,6,650
20181014,28187,25687,2500,9.73,304.174,251.547,0,651
20181015,33621,30538,3083,10.09,351.048,290.31,1,652
20181016,33855,31462,2393,7.6,363.656,300.737,2,653
20181017,32748,30079,2669,8.87,354.408,293.09,3,654
20181018,32871,30097,2774,9.22,352.926,291.864,4,655
20181019,32840,29952,2888,9.64,350.484,289.844,5,656
20181020,29354,26206,3148,12.01,319.19,263.965,6,657
20181021,28143,25377,2766,10.9,301.962,249.718,0,658
20181022,32588,30240,2348,7.77,346.347,286.423,1,659
20181023,32530,30450,2080,6.83,357.445,295.601,2,660
20181024,32800,30549,2251,7.37,357.468,295.62,3,661
20181025,33145,31029,2116,6.82,360.218,297.895,4,662
20181026,33166,31014,2152,6.94,358.892,296.798,5,663
20181027,28843,25586,3257,12.73,314.868,260.391,6,664
20181028,27404,24289,3115,12.83,288.489,238.576,0,665
20181029,31551,28439,3112,10.94,325.975,269.576,1,666
20181030,31630,29073,2557,8.8,339.912,281.101,2,667
20181031,31822,29060,2762,9.51,341.147,282.123,3,668
20181101,31141,28605,2536,8.87,338.427,264.171,4,669
20181102,31246,28905,2341,8.1,341.673,266.706,5,670
20181103,28411,26486,1925,7.27,318.748,248.811,6,671
20181104,27519,25391,2128,8.38,302.451,236.09,0,672
20181105,31977,29866,2111,7.07,345.595,269.766,1,673
20181106,32894,30772,2122,6.9,360.612,281.488,2,674
20181107,32912,30941,1971,6.37,363.293,283.582,3,675
20181108,33332,31419,1913,6.09,366.131,285.797,4,676
20181109,32402,30295,2107,6.96,358.827,280.095,5,677
20181110,28820,26927,1893,7.03,325.954,254.435,6,678
20181111,28100,25556,2544,9.95,306.277,239.076,0,679
20181112,32053,29963,2090,6.98,346.089,270.152,1,680
20181113,31552,29512,2040,6.91,351.067,274.039,2,681
20181114,31446,29437,2009,6.83,348.102,271.723,3,682
20181115,31899,29920,1979,6.61,352.424,275.097,4,683
20181116,32064,29969,2095,6.99,354.826,276.972,5,684
20181117,28499,26630,1869,7.02,323.609,252.605,6,685
20181118,27488,25682,1806,7.03,306.913,239.572,0,686
20181119,31121,29184,1937,6.64,340.579,265.852,1,687
20181120,31650,29730,1920,6.46,348.496,272.032,2,688
20181121,31958,30019,1939,6.46,353.98,276.312,3,689
20181122,31335,28817,2518,8.74,343.644,268.244,4,690
20181123,31109,28416,2693,9.48,337.844,263.716,5,691
20181124,28177,24811,3366,13.57,301.231,235.136,6,692
20181125,27898,24821,3077,12.4,292.251,228.127,0,693
20181126,30800,28884,1916,6.63,330.964,258.346,1,694
20181127,30846,29017,1829,6.3,339.072,264.675,2,695
20181128,30859,28956,1903,6.57,339.211,264.784,3,696
20181129,30731,28691,2040,7.11,336.713,262.833,4,697
20181130,30745,28562,2183,7.64,337.962,263.809,5,698
20181201,28312,25636,2676,10.44,312.456,209.292,6,699
20181202,27433,24981,2452,9.82,295.658,198.04,0,700
20181203,30857,28963,1894,6.54,336.661,225.505,1,701
20181204,31720,29868,1852,6.2,350.305,234.644,2,702
20181205,31347,29406,1941,6.6,350.37,234.687,3,703
20181206,31885,30019,1866,6.22,355.156,237.893,4,704
20181207,30223,28355,1868,6.59,342.55,229.449,5,705
20181208,27838,25188,2650,10.52,308.049,206.34,6,706
20181209,26694,24038,2656,11.05,289.51,193.922,0,707
20181210,30540,28631,1909,6.67,331.126,221.798,1,708
20181211,30516,28683,1833,6.39,342.354,229.318,2,709
20181212,30171,28236,1935,6.85,335.394,224.657,3,710
20181213,30075,28180,1895,6.72,336.03,225.082,4,711
20181214,30137.4,28184,1953.4,6.93,337.91,226.341,5,712
20181215,27951,25401,2550,10.04,309.932,207.601,6,713
20181216,26687,24544,2143,8.73,293.571,196.642,0,714
20181217,29608,27835,1773,6.37,323.984,217.013,1,715
20181218,29895,28111,1784,6.35,333.25,223.22,2,716
20181219,30177,28371,1806,6.36,336.053,225.097,3,717
20181220,30316,28520,1796,6.3,336.419,225.343,4,718
20181221,30641,28647,1994,6.96,339.254,227.242,5,719
20181222,29051,27178,1873,6.89,330.963,221.688,6,720
20181223,26965,24509,2456,10.02,297.123,199.022,0,721
20181224,30268,27928,2340,8.38,325.754,218.199,1,722
20181225,30545,28585,1960,6.85,340.321,227.956,2,723
20181226,30243,28463,1780,6.25,339.702,227.542,3,724
20181227,29662,27726,1936,6.98,332.31,222.591,4,725
20181228,28906,26844,2062,7.68,322.74,216.181,5,726
20181229,27586,24309,3277,13.48,294.146,197.028,6,727
20181230,25088,23326,1762,7.55,280.023,187.568,0,728
20181231,26505,23399,3106,13.27,277.72,186.024,1,729
20190101,26429,23872,2557,10.71,279.87,192.192,2,730
20190102,30047,28148,1899,6.75,323.08,221.864,3,731
20190103,30343,28452,1891,6.65,336.597,231.146,4,732
20190104,30301,28490,1811,6.36,339.02,232.81,5,733
20190105,27957,26054,1903,7.3,315.825,216.882,6,734
20190106,26950,24617,2333,9.48,295.08,202.637,0,735
20190107,30336,28536,1800,6.31,330.919,227.247,1,736
20190108,30562,28719,1843,6.42,340.713,233.974,2,737
20190109,30595,28641,1954,6.82,339.42,233.086,3,738
20190110,30853,29006,1847,6.37,345.741,237.426,4,739
20190111,30682,28798,1884,6.54,345.312,237.131,5,740
20190112,28402,25905,2497,9.64,316.377,217.261,6,741
20190113,27027,24629,2398,9.74,295.069,202.629,0,742
20190114,30093,28348,1745,6.16,330.529,226.979,1,743
20190115,30731,28887,1844,6.38,341.979,234.843,2,744
20190116,30498,28649,1849,6.45,338.771,232.64,3,745
20190117,30328,28395,1933,6.81,337.237,231.587,4,746
20190118,29691,27756,1935,6.97,333.578,229.073,5,747
20190119,28431,26477,1954,7.38,323.444,222.114,6,748
20190120,27138,24539,2599,10.59,293.809,201.764,0,749
20190121,29654,27739,1915,6.9,324.539,222.866,1,750
20190122,30061,28140,1921,6.83,334.246,229.532,2,751
20190123,29776,27838,1938,6.96,333.761,229.199,3,752
20190124,29735,27863,1872,6.72,334.577,229.76,4,753
20190125,29202,27296,1906,6.98,332.047,228.022,5,754
20190126,27817,25282,2535,10.03,307.745,211.333,6,755
20190127,26506,24414,2092,8.57,291.033,199.857,0,756
20190128,29363,27557,1806,6.55,322.911,221.749,1,757
20190129,29690,27858,1832,6.58,331.844,227.883,2,758
20190130,29570,27760,1810,6.52,331.523,227.663,3,759
20190131,29071,27181,1890,6.95,326.577,224.266,4,760
